11111111111111111111111111111111111111111111111111111111
100000C000000000100000000000000000C00000000000000000C001
100000000000000010000000000000000000000000C0000000000001
100C0000000000001001111111000000000011000000000011111111
100C0000000000001001000001000000000011000000000000000001
100000000000000010010C1001000000000011000000000000000001
1E000000000000001001111001000000000011000000000000000001
10000000000C0000100000000100000C000011000000000000000001
100000C00000000011111111110000000000110000000000000C0001
1000000000000000000C000C00000C00000011000000000000000001
1P0C00000000000000000000000000000000110000000000000C0001
11111111111111111111111111111111111111111111111111111111