111111111111111111111
100000000000000100001
10000000000E000111111
10000000P0000000C0000
111111111111111111111
